R 1000 720
NO      ./srcs/brick.xpm
SO          ./srcs/eagle.xpm
WE                          ./srcs/colorstone.xpm
EA                                  ./srcs/brick.xpm




S                           ./srcs/pillar.xpm 
F 220,100,0
C 225,30,0
11111
10001
10W001
10001
10101
10001
11111





