R 1920 1080
NO ./path_to_the_north_texture
SO ./path_to_the_south_texture
WE ./path_to_the_west_texture
EA ./path_to_the_east_texture
S ./path_to_the_sprite_texture
F 220,100,0 
C 225,30,0 
11111111111  111111111111
10000000001  1000000000001
10110000011  1000000200001
10010000001  1000S0000001
11111111101  1000001110001
11111111111  1111111111111