R 1109 1111
NO      ./srcs/bluestone.xpm

SO          ./srcs/eagle.xpm
WE                          ./srcs/colorstone.xpm
EA                                  ./srcs/redbrick.xpm




S                           ./srcs/pillar.xpm 
F 100,100,255
C 100,255,100

111111111
10000000011111
1000000000201
10S0222000111
1000002001
1000000001
1220000001
1111111111



